{
  "start_pos": [30, 200],
  "theme": "grass",
  "objects": {
    "flags": [

    ],
    "fruits": [

    ],
    "platforms": [

    ],
    "spikes": [

    ],
    "obstacles": [

    ]
  },
  "tilemap": [
      "p//////////////p",
      "p//////////////p",
      "p//////////////p",
      "p//////////////p",
      "p//////////////p",
      "p//////////////p",
      "p//////////////p",
      "p//////////////p",
      "p//////////////p",
      "p//////////////p",
      "p//////////////p",
      "p//////////////p",
      "p//////////////p",
      "p//////////////p",
      "p//////////////p",
      "p//////////////p",
      "p//////////////p",
      "pNNNNNN////////p",
      "p//////////N///p",
      "p//////////C///p",
      "p//////////C///p",
      "pNN///NN///C///p",
      "pCC////////////p",
      "pC/////////////p",
      "p//////////////p"
  ]
}